+---------------------------------------------------------------------+
|                                       XXXXXXXXXXXX                  |
|        XXXXXXXXXX                     XXXXXXXXXXX                   |
|       XXXXXXXXXXX                                       ?           |
|      XXXXXXXXXXXXX       XXXXXXXX                          ___      |
|      XXX XXXXXXXXX      XXXXXXXXXXXXXXX                   +___+/+   |
|      XXXX XXXXXXXXX      X XXXXXXXXXXXX                <[[__^___|   |
|       XXXX XXXXXXXX     XXXXXXXX XXXXXX       XXXXXXXX XXXXXX       |
|             XXXXX    XXXXXXXXXXXXXXXXXXX       XXXXXXXXXXXX X       |
|             XXXX    XX XXXXXXXXXXXXXXXXX   ?   XXXXXXX X XXXX       |
|             X       XXXXXXXXXXXXX XXXXXX       XXXXXXXXXXXXX        |
|    ?                XXXXXXXXX  XXXXXXXXX      XXXXX XXXXXX    ▄     |
|                     X XXXXXX    XXX X XX      XXXXXXXX              |
|                      XXXXXXX     XXXXXXX      XXXXXXX               |
|                      X XXXXX     X XXXXX     XXXXXXXX               |
|                       XXXXXX     XX XXXX     XXXXXXX                |
|                      ?           XXXXXXX     XXXXX          ?       |
| ?                            ?   XXX XXX                            |
|                XXXXXXX XXXXXXXXXXXXXXXXX                            |
|         ╬     XXXXXXXXXXXXXXXXX XXXXXXX X            ?              |
|             XXXXXXXXXXXXXXXXXXXXXXXXXXXXXX                      XXXX|
|            XXXXXXXXXXXXXXXXXXXXXXXXXXXXXXXX             XXXXXX XXXXX|
|             XXXXXXXXXXXXXXXXXXXXXXXXXXXXXXXXX          XXXXXXXXXXXXX|
|  ?        XXXXXXXXXXXXXXXXXXXXXXXXXXXXXXXXXXXX         XXXXXXXXXXXXX|
|          XXXXXXXXXXXXX         qq     XXXXXXXX         XXXXXXXXXXXXX|
+         XXXXXXXXXXXXXXXX      qqqq     XXXXXXX         XXXXXXXXXXXXX|
XXXXXXX   XXXXXXXXXXXXXXXXX    qqqqqq XXXXXXXXXX     ╧   XXXXX XXXXXXX|
+XXXXXX      XXXXXXXXXXXXXXX   }    + XXXXXXXXXX         XXX   XXXXXXX|
|XXXXXXX       XXXXXXXXX XXX   +----+ XXXXXXXXX                XXXXXXX|
|XXXXXXXX       XXXXXX XXXXX          XXXXXXXX                XXXXXXXX|
|XXXXXXXX       XXXXXXXXXXX                                ?  XXXXXXXX|
|XXXXXX          XXXXXXXXX                        XXX                 |
|XXXXXX  ?                    _____     ¥      XXXXXXX                |
|XXXXXXX                     /_____\         XXXXXXXXX                |
|XXXXXXX    ?               /_______+]]>    XXXXXXXXXXXXXXX           |
|XXXXXXXX              ?                    XXXXXXXXXXXXXXXX          |
+---------------------------------------------------------------------+

